00000000001000001110
01110000111100111010
00100000100100100010
0011111110011010001G
11101000111000100010
00001010000111100100
11111111110100111100
01000100100100100000
01011100100100000010
01000100100111111111
11010101111100101001
01110100000011101001
01000100111110001001
01000000000100000011
01111000111111001110
00001000100000000010
00111100100011111110
00100111110000010011
po100100010011110001
11100100011000g00001

yYhHnN