22222222222222222222
22222222222222222222
22111111122111111g22
2211Y111122111111122
22111111122111111122
2211111112211h111122
22111111122111111122
221n1111122111111122
22111111122o11111122
22222222222222222222
22222222222222222222
22111111p22111111122
22111111122111111122
22y11111122111111122
22111111122111H11122
22111111122111111122
22111111122111N11122
22G11111122111111122
22222222222222222222
22222222222222222222