00200000000000000000
00g00000000000000000
20211111111111100000
00100000000000100000
00100000000000100000
00100000000000100000
00121111111000100000
00100000012220100000
001000111p2220100000
00100012211111111000
00100012212222201000
00100012222212201000
00111111111112201000
0001000012221o111000
00010000122212221000
00011111111120221000
00000000000012221000
00000000000021111000
000000000000G0000000
00000000000020000000

yYhHnN