00001121111G20000000
00001010000000000000
00002110000000000000
00000010000000000000
00000011110000000000
000000000100000111p0
00000000011000010000
00000011112111110000
00000010011000010000
00111110001000010000
00100010001000010000
21211121111000010000
001000100000000o0000
00100020000000000000
00100000000000000000
00g00000000000000000
00200000000000000000
00000000000000000000
00000000000000000000
00000000000000000000

yYhHnN