00000000000000000000
00000000000020000000
000000000000h2000000
00000000000010000000
00000000000010000000
00000000000010000020
0011111110001p1111N0
00100000100000000011
00100000y00000000001
00111111220000000001
00100000100000000001
00100000p00000000001
00100000111o11111001
00100000100000001001
00100000100000001001
02H11111211110021001
00200000102021101001
0010000010001011Y211
11120001100010002000
G00n111120001111g000

yYhHnN