p212121212122212121G
21222121212121212121
12121222122212121212
11212121212121212221
12122212121212121212
21211121212121212121
12121212121212121212
21212122212121212221
12121212121212121212
21211221212122212121
12221212121212121212
21212121212121212121
12121212122212122212
21212121212121212121
22121212121212121212
21212121212122212221
12121212221212121212
21122121212121212121
12121212121222121212
g121222121212121212o

yYhHnN