G0000000000000000000
p0000000000000000000
20000000000000000000
10000000000000000000
11121112000000000000
10000100000000000000
20000100000000000000
00000200000000000000
00000100011000200000
00000111112200100000
00000100001111100000
00000200001000100000
00000000002000200000
00000000000000100002
00000000000000100001
00000000000021112111
00000000000000000001
00000000000000000002
0000000000000000000o
0000000000000000000g

yYhHnN