10o12021001010011010
1001202100101001101g
1001202100101001101G
10p12021001010011010
10012021001010011010
10012021001010011010
10012021001010011010
10012021Y01010011010
10012021y01010011010
10012021H01010011010
10012021h01010011010
10012021N01010011010
10012021n01010011010
10012021001010011010
10012021001010011010
10012021001010011010
10012021001010011010
10012021001010011010
10012021001010011010