00000000000000000000
00000000000000000000
00000000000000000000
00000000000000000000
00000000000000000000
g000000000000000000G
10000000000000000001
10000000000000000001
11111111111111111111
00000002211220000000
00000022111122000000
00000221112112200000
00002212121212220000
00022121212221222000
00221212221212122200
02212221212122212220
22121212121212121222
21111111111111111112
21222222222222222212
0o0000000000000000p0

yYhHnN